name Fail Dungeon of Doom
win poop
###################
#.................#
#.................#
#.................#
#.................#
#..........G......#
#.................#
#.................#
###################